"a" = (/turf/unsimulated/floor/overmap,/area/space)
"b" = (/obj/effect/light_emitter,/turf/unsimulated/wall/overmap,/area/space)
"c" = (/turf/unsimulated/wall/overmap,/area/space)
"d" = (/obj/effect/light_emitter,/obj/effect/landmark/overmap/center,/turf/unsimulated/floor/overmap,/area/space)
"e" = (/turf/space,/area/space)

(1,1,1) = {"
eeeeeeeeeeeeeeeeeeeeeeeeeeeeeeeeeeeeeeeeeeeeeeeeeeeeeeeeeeeeeeeeeeeeeeee
cbccccccccbccccccccbceeeeeeeeeeeeeeeeeeeeeeeeeeeeeeeeeeeeeeeeeeeeeeeeeee
baaaaaaaaaaaaaaaaaaabeeeeeeeeeeeeeeeeeeeeeeeeeeeeeeeeeeeeeeeeeeeeeeeeeee
caaaaaaaaaaaaaaaaaaaceeeeeeeeeeeeeeeeeeeeeeeeeeeeeeeeeeeeeeeeeeeeeeeeeee
caaaaaaaaaaaaaaaaaaaceeeeeeeeeeeeeeeeeeeeeeeeeeeeeeeeeeeeeeeeeeeeeeeeeee
caaaaaaaaaaaaaaaaaaaceeeeeeeeeeeeeeeeeeeeeeeeeeeeeeeeeeeeeeeeeeeeeeeeeee
caaaaaaaaaaaaaaaaaaaceeeeeeeeeeeeeeeeeeeeeeeeeeeeeeeeeeeeeeeeeeeeeeeeeee
caaaaaaaaaaaaaaaaaaaceeeeeeeeeeeeeeeeeeeeeeeeeeeeeeeeeeeeeeeeeeeeeeeeeee
caaaaaaaaaaaaaaaaaaaceeeeeeeeeeeeeeeeeeeeeeeeeeeeeeeeeeeeeeeeeeeeeeeeeee
caaaaaaaaaaaaaaaaaaaceeeeeeeeeeeeeeeeeeeeeeeeeeeeeeeeeeeeeeeeeeeeeeeeeee
caaaaaaaaaaaaaaaaaaaceeeeeeeeeeeeeeeeeeeeeeeeeeeeeeeeeeeeeeeeeeeeeeeeeee
baaaaaaaaadaaaaaaaaabeeeeeeeeeeeeeeeeeeeeeeeeeeeeeeeeeeeeeeeeeeeeeeeeeee
caaaaaaaaaaaaaaaaaaaceeeeeeeeeeeeeeeeeeeeeeeeeeeeeeeeeeeeeeeeeeeeeeeeeee
caaaaaaaaaaaaaaaaaaaceeeeeeeeeeeeeeeeeeeeeeeeeeeeeeeeeeeeeeeeeeeeeeeeeee
caaaaaaaaaaaaaaaaaaaceeeeeeeeeeeeeeeeeeeeeeeeeeeeeeeeeeeeeeeeeeeeeeeeeee
caaaaaaaaaaaaaaaaaaaceeeeeeeeeeeeeeeeeeeeeeeeeeeeeeeeeeeeeeeeeeeeeeeeeee
caaaaaaaaaaaaaaaaaaaceeeeeeeeeeeeeeeeeeeeeeeeeeeeeeeeeeeeeeeeeeeeeeeeeee
caaaaaaaaaaaaaaaaaaaceeeeeeeeeeeeeeeeeeeeeeeeeeeeeeeeeeeeeeeeeeeeeeeeeee
caaaaaaaaaaaaaaaaaaaceeeeeeeeeeeeeeeeeeeeeeeeeeeeeeeeeeeeeeeeeeeeeeeeeee
caaaaaaaaaaaaaaaaaaaceeeeeeeeeeeeeeeeeeeeeeeeeeeeeeeeeeeeeeeeeeeeeeeeeee
baaaaaaaaaaaaaaaaaaabeeeeeeeeeeeeeeeeeeeeeeeeeeeeeeeeeeeeeeeeeeeeeeeeeee
cbccccccccbccccccccbceeeeeeeeeeeeeeeeeeeeeeeeeeeeeeeeeeeeeeeeeeeeeeeeeee
"}
